11111111
1P000E01
10000011
100001C1
11111111