1111111111111
1P000000C0001
1000111111111
10E0100000C01
1111111111111