1111111111111
1P000000C0001
1000111111111
1000100000E01
1111111111111