1111111111
100000C001
1000P00001
1000E00001
1111111111