1111111111
10P0000C01
100B000101
10CC1E1101
1111111111