1111111111
10PCC00C01
100101CC01
10CC0E0101
1111111111