1111111111
10P0C0EC01
100101CC01
10CC0C0101
1111111111