1111111111
100C0C0001
1001P10001
1000E00101
1111111111