1111111111
10P000EC01
1001010C01
10CC0C0101
1111111111