1111111111
10C00000C1
1001P10C01
1000E00101
1111111111