1111111111
10C0C0EC01
1001P10C01
10000C0101
1111111111