1111111111
100P0E0C01
1001001001
10C0000001
1111111111