1111111111
100P0E0C01
1111111111
10C0000001
1111111111