1111111111111
1P000000CB001
1B00101111111
10E0100000C01
1111111111111