1111111111
10PC0C0C01
100F0C0101
10CC1E1101
1111111111