1111111111111
1P000000CF001
1F00101111111
10E0100000C01
1111111111111