1111111111111
1P000W00C0001
1000101111111
10E01FF000C01
1111111111111