1111111111111
1P000000C01111
100010111111
10E0000000111
1111111111111