1111CC1111111
1P000000C0001
1000101111110
10E0100000C01
1111110011111